19 19 19 32 32 32 32 32 32 32 32 32 32 32 32
19 19 29 21 21 21 21 21 21 21 21 21 21 21 21
19 19 21 21 21 21 21 21 21 21 21 21 21 21 29
19 21 21 21 21 21 21 21 21 21 21 21 21 29 29
21 21 21 21 21 21 21 21 21 21 21 29 29 29 29
21 21 21 21 21 21 21 21 21 21 21 29 29 29 29
21 21 21 21 21 21 21 21 21 21 21 29 29 29 29
19 19 21 21 21 21 21 21 21 21 21 21 21 29 29
19 19 21 21 21 21 21 21 21 21 21 21 21 21 29
19 21 28 21 21 21 21 21 21 21 21 21 21 21 21
32 32 32 32 32 32 32 32 32 32 32 32 32 32 32