32 32 32 32 32 32 32 32 32 19 19 19 19 19 19
21 21 21 21 30 30 30 21 21 21 21 19 19 19 19
21 20 21 21 21 21 21 21 21 21 21 19 19 19 19
21 20 21 21 21 21 21 21 21 21 21 21 19 19 19
21 20 21 21 21 21 21 21 21 21 21 21 21 21 21
21 20 21 21 21 21 21 21 21 21 21 21 21 21 21
21 21 21 21 21 21 21 21 21 21 21 21 21 21 21
21 21 21 30 30 21 21 21 21 21 21 21 19 19 19
21 21 21 30 30 21 21 21 21 21 19 19 19 19 19
21 21 21 21 21 21 21 21 21 21 19 19 19 19 19
32 32 32 32 32 32 32 32 32 19 19 19 19 19 19