0 0 0 0 0 0 3 3 3 0 0 0 0 0 0
0 0 0 0 0 0 3 3 3 0 4 0 0 0 0 
0 0 0 0 0 0 3 3 3 5 8 6 0 0 0
10 10 10 10 10 0 3 3 3 0 7 0 0 0 0
10 9 9 9 10 0 3 3 3 3 3 3 3 3 3 
10 9 9 9 10 15 3 3 3 3 3 3 3 3 3 
10 9 9 9 10 0 3 3 3 3 3 3 3 3 3
10 10 10 10 10 0 0 0 0 0 4 0 0 0 0 
0 0 0 0 0 0 0 0 0 5 8 6 0 0 0 
0 0 0 0 0 0 0 0 0 0 7 0 0 0 0 
0 0 0 0 0 0 0 0 0 0 0 0 0 0 0 
