0 0 0 0 0 0 3 3 3 0 0 0 0 0 0
0 0 0 0 0 0 3 3 3 0 4 0 0 0 0 
0 0 0 0 0 0 3 3 3 5 8 6 0 0 0
9 9 9 9 9 0 3 3 3 0 7 0 0 0 0 
9 9 9 9 9 0 3 3 3 3 3 3 3 3 3 
9 9 9 9 9 1 3 3 3 3 3 3 3 3 3 
9 9 9 9 9 0 3 3 3 3 3 3 3 3 3
9 9 9 9 9 0 0 0 0 0 4 0 0 0 0 
0 0 0 0 0 0 0 0 0 5 8 6 0 0 0 
0 0 0 0 0 0 0 0 0 0 7 0 0 0 0 
0 0 0 0 0 0 0 0 0 0 0 0 0 0 0 
