0 0 0 0 0 0 3 3 3 0 0 0 0 0 0
0 0 0 0 0 0 3 3 3 0 4 0 0 0 0 
0 0 0 0 0 0 3 3 3 5 0 6 0 0 0
1 1 1 1 1 0 3 3 3 0 7 0 0 0 0 
1 1 1 1 1 0 3 3 3 3 3 3 3 3 3 
1 1 1 1 1 1 3 3 3 3 3 3 3 3 3 
1 1 1 1 1 0 3 3 3 3 3 3 3 3 3
1 1 1 1 1 0 0 0 0 0 4 0 0 0 0 
0 0 0 0 0 0 0 0 0 5 0 6 0 0 0 
0 0 0 0 0 0 0 0 0 0 7 0 0 0 0 
0 0 0 0 0 0 0 0 0 0 0 0 0 0 0 
