0 0 0 00 12 12 12 12 12 00 00 0 0 0 0 
0 0 0 00 12 12 12 12 12 00 00 0 0 0 0 
0 0 0 00 12 12 12 12 12 00 00 0 0 0 0 
0 0 0 00 00 00 14 00 0 00 00 0 0 0 0 
3 3 3 03 03 3 03 03 3 03 03 3 3 3 3
3 3 3 03 03 3 03 03 3 03 03 3 3 3 3
3 3 3 03 03 3 03 03 3 03 03 3 3 3 3
0 0 0 00 00 0 00 00 0 00 00 0 0 0 0 
0 10 10 10 10 10 10 10 10 10 10 0 0 0 10 
0 10 11 11 02 11 11 02 11 11 10 0 0 0 10 
0 10 11 11 02 11 11 02 11 11 10 0 0 0 10  
