1 1 1 1 1 1 1 1 1 1 1 1 1 1 1 1
1 0 0 0 0 0 0 0 0 0 0 0 0 0 0 1
1 0 0 0 0 0 0 0 0 0 0 0 0 0 0 1
1 0 0 0 0 0 0 0 0 0 0 0 0 0 0 1
1 0 0 0 2 2 2 7 2 2 2 0 0 0 0 1
1 0 0 0 2 2 2 7 2 2 2 0 0 0 0 8
1 0 0 0 2 2 2 7 2 2 2 0 0 0 0 9
1 0 0 0 2 2 2 7 2 2 2 0 0 0 0 1
1 0 0 0 2 2 2 7 2 2 2 0 0 0 0 1
1 0 0 0 0 0 0 0 0 0 0 0 0 0 0 1
1 0 0 0 0 0 0 0 0 0 0 0 0 0 0 1
1 1 1 1 1 1 1 1 1 1 1 1 1 1 1 1 