00 00 13 12 12 12 12 12 12 12 12 13 0 0 0
00 00 13 12 12 12 12 12 12 12 12 13 0 0 0
00 00 13 13 13 13 13 13 13 13 13 13 0 0 0
00 00 00 00 00 00 00 00 00 0 0 0 0 0 0 
03 03 03 03 03 03 03 03 03 3 3 3 3 3 3
03 03 03 03 03 03 03 03 03 3 3 3 3 3 3
03 03 03 03 03 03 03 03 03 3 3 3 3 3 3
00 00 00 00 00 00 00 00 00 0 0 0 0 0 0 
10 10 10 10 10 10 10 10 10 0 0 0 0 0 0 
11 11 02 11 11 02 11 11 10 0 0 0 0 0 0
11 11 02 11 11 02 11 11 10 0 0 0 0 0 0