1 1 1 1 1 1 1 1 1 1 1 1 1 1 1 1 
1 17 0 0 0 0 0 0 0 0 0 0 0 0 0 
1 0 0 0 0 0 0 0 0 0 0 0 0 0 0 
1 0 0 0 0 0 0 0 0 0 0 17 0 0 0 
1 0 0 0 3 3 3 7 3 3 3 17 0 0 0 
1 0 0 0 3 3 3 7 3 18 3 17 0 0 0 
1 0 0 0 3 3 3 7 18 18 3 17 0 0 0 
1 0 0 0 3 3 3 7 3 3 3 17 0 0 0 
1 0 0 0 3 3 3 7 3 3 3 17 17 17 17 
1 0 0 0 0 0 0 0 20 0 0 0 0 0 17 
1 19 0 0 0 0 0 0 0 0 0 0 0 17 17 
