0 0 0 0 17 17 17 17 17 17 17 17 17 17 17
0 0 0 0 17 17 17 17 17 17 17 17 17 17 17
0 0 0 17 17 17 17 17 17 17 17 17 17 17 17
0 0 0 17 17 17 17 17 17 17 17 17 17 17 17
3 3 3 18 18 18 18 18 18 18 18 18 18 18 18
3 18 18 18 18 18 18 18 18 18 18 18 18 18 18
3 3 18 18 18 18 18 18 18 18 18 18 18 18 18
0 0 17 17 17 17 17 17 18 18 18 17 17 17 17
0 0 17 17 17 17 17 17 18 18 18 17 17 17 17
0 17 17 17 17 17 17 17 18 18 18 17 17 17 17
0 17 17 17 17 17 17 17 18 18 18 17 17 17 17
