17 17 17 17 17 17 17 17 18 18 18 17 17 17 17
26 26 17 17 17 17 17 17 18 18 18 17 17 17 17
19 19 26 26 17 17 17 17 18 18 18 17 17 17 17
19 19 19 19 26 17 17 17 18 18 18 17 17 17 17
19 19 19 19 19 26 17 17 18 18 18 17 17 17 17
19 19 19 19 19 26 17 17 18 18 18 17 17 17 17
19 19 19 19 19 26 17 17 18 18 18 17 17 17 17
19 19 19 19 26 17 17 17 18 18 18 17 17 17 17
19 19 19 19 26 17 17 17 18 18 18 17 17 17 17
19 19 19 26 17 17 17 17 18 18 18 17 17 17 17
19 26 26 17 17 17 17 17 18 18 18 17 17 17 17
