17 17 17 17 17 17 17 17 18 18 18 17 17 17 17
17 17 17 17 17 17 17 17 18 18 18 17 17 17 17
17 17 17 17 17 17 17 17 18 18 18 17 17 17 17
17 17 17 17 17 17 17 17 18 18 18 17 17 17 17
18 18 18 18 18 18 18 18 18 18 18 17 17 17 17
18 18 18 18 18 18 18 18 18 18 18 17 17 17 17
18 18 18 18 18 18 18 18 18 18 18 17 17 17 17
17 17 17 17 17 17 17 17 17 17 17 17 17 17 17
17 17 17 17 17 17 17 17 17 17 17 17 17 17 17
17 17 17 17 17 17 17 17 17 17 17 17 17 17 17
17 17 17 17 17 17 17 17 17 17 17 17 17 17 17

