17 17 17 17 17 17 17 17 17 17 17 17 17 17 17
17 17 17 17 17 21 21 21 17 17 17 17 17 17 17
17 17 17 17 21 21 21 21 21 17 17 17 17 17 17
17 17 17 17 21 21 20 21 21 18 18 18 18 17 17
17 17 17 17 21 21 20 21 21 18 18 18 18 18 18
17 17 17 17 21 21 20 21 21 18 18 18 18 18 18
17 17 17 17 21 21 20 21 21 18 18 18 18 18 18
17 17 17 17 21 21 21 21 21 17 17 17 17 17 17
17 17 17 17 17 21 21 21 17 17 17 17 17 17 17
17 17 17 17 17 17 17 17 17 17 17 17 17 17 17
17 17 17 17 17 17 17 17 17 17 17 17 17 17 17
